cambiare=zmieniać
cambiarsi=przebierać się
vecchio=stary
insegnante=nauczyciel
spiegazione=wyjaśnienie
comprare=kupować
quaderno=zeszyt
copiare=kopiować
correggere=poprawiać
desiderare=pragnąć
salutare=witać
dimenticare=zapominać
spesso=często
dipingere=malować
dividere=dzielić
camera=pokój
firmare=podpisywać
assegno=czek
fissare l'appuntamento=ustalić spotkanie
guardare=patrzeć
guidare=prowadzić
macchina=samochód
soldi=pieniądze
spendere=wydawać;spędzać
partire=wyjeżdżać
suonare=grać
rispondere=odpowiadać
domanda=pytanie
parola=słowo
ogni=każdy
pranzare=jeść obiad
conoscere=znać
moglie=żona
preferire=woleć
restare=zostawać
regalo=prezent
fiori=kwiaty
quella=tamtej
preparare=przygotowywać
cena=kolacja
spiegarsi=wyrażać się jasno
miei=moi
spiegare=wyjaśniać
cercare=szukać
offrire=proponować;stawiać
carino=ładny
sicuro=bezpieczny
albergo=hotel
gusto=smak
pulire=czyścić
dolce=słodki
chiaro=jasny
gelato=lody
gita=wycieczka
ogni=każdy
scogli=skały
gnomo=krasnal
questo=ten
scimmia=małpa
percio=dlatego;więc
cercare di=próbować
fare=robić
fare una gita=jechać na wycieczkę
campagna=wieś
pigro=leniwy
facile=łatwe
giovane=młody
albero=drzewo
uccello=ptak
imballaggio=opakowanie
tavolo=stół
bicchiere=szklanka;kieliszek
straniero=obcy
pneumatico=opona
gnocco=kluseczka
zaino=plecak
zucchero=cukier
strada=ulica
palla=piłka
zanzara=komar
alba=świt
arancia=pomarańcza
studio=gabinet
stivale=but
mano=ręka
scelta=wybór
scontro=zderzenie
ostrica=ostryga
dente=ząb
chiave=klucz
tedesco=niemiecki
esame=egzamin
giornale=gazeta
piu triste=najsmutniejszy
nello stesso tempo=w tym samym czasie
triste=smutny
quello=tamten;taki
lasciare=zostawiać;pozwalać
insomma=w sumie
quasi=prawie
impaziente=niecierpliwy
mattina=rano
valigia=walizka
ero=byłem
cosi=w ten sposób
stanco=zmęczony
appena=z trudem;dopiero co
svegliare=budzić
pomeriggio=popołudnie
abituare=przyzwyczajać
un po=nieco
marito=mąż
maglie=żona
ferie=wakacje
attesa=oczekiwanie
il permeso di soggiorno=pozwolenie na pobyt
poi=potem
sistemare=układać
ogni tanto=raz na jakiś czas
pensare=myśleć
ora=teraz
pensione=pensjonat
imparare=nauczyć się
ufficio commerciale=biuro handlowe
utile=użyteczny
spesso=często
in affitto=do wynajęcia
passare per=przechodzić przez
a buon mercato=po dobrej cenie
tornare=wracać
segno=znak
segnare=zaznaczać
seguire=śledzić
quale=jaki;który;jak
quanto=ile
vero=prawda
falso=fałsz
ripetere=powtarzać
seguente=następny
domanda=pytanie
orribili=beznadziejny
infatti=rzeczywiście
buono=dobry
invece=jednak
ballare=tańczyć
se=jeśli
noioso=nudny
ridere=śmiać się
neanche=nawet nie
divertirsi=bawić się
sapere=wiedzieć;umieć
uscire=wychodzić
dormire=spać
scherzare=żartować
schedare=katalogować
anche=również
soffrire=cierpieć
sento=czuję
sentire=słyszeć;czuć
vivrebbe=żyłoby się
saremmo=bylibyśmy
sopratutto=przede wszystkim
meglio=lepiej
comunque=mimo wszystko;jednak
nessuno=nikt
pazzo=szalony
consiglio=rada
il migliore=najlepszy
crescere=rosnąć
lettera=list;litera
abbastanza=raczej
piu=więcej;bardziej
luminoso=oświetlony
mentre=podczas
curati=zadbany
salotto=salon
caro=drogi
mobili=meble
avere paura=bać się
pronto=halo;gotowy;szybki
finalmente=wreszcie
gentile=uprzejmy
disturbare=przeszkadzać
troppo=zbyt
intento=zamiar
ricetta=recepta;przepis
segreto=sekret
intanto=tymczasem
in generale=ogólnie
vicino=blisko
veramente=naprawdę
contento=zadowolony
eccitato=podekscytowany
di solito=zazwyczaj
insieme=razem
mandare=wysyłać
invito=zaproszenie
niente=nic
poi=potem
giorno dopo=następny dzień
serata=wieczór
mazzo di fiori=bukiet kwiatów
ringraziare=dziękować
erba=trawa
verde=zielony
vuoto=pusty
pieno=pełny
bello=piękny
brutto=brzydki
alto=wysoki
basso=niski
magro=szczupły
grasso=gruby
largo=szeroki
stretto=wąski
grande=wielki
piccolo=mały
giovane=młody
vecchio=stary
buono=dobry
cattivo=zły
facile=łatwy
dificile=trudny
corto=krótki
lungo=długi
preso=wcześnie
tardi=późno
veloce=szybki
lento=wolny
interessante=interesujący
costoso=drogi
economico=tani
sano=zdrowy
malato=chory
caldo=ciepły
freddo=zimny
leggero=lekki
pesante=ciężki
interno=wewnętrzny
esterno=zewnętrzny
bagnato=mokry
secco=suchy
ricco=bogaty
povero=biedny
attivo=aktywny
passivo=pasywny
nuovo=nowy
vecchio=stary
certo=pewny
incerto=niepewny
morbido=miękki
duro=twardy
mela=jabłko
zaino=plecak
sporco=brudny
pulito=czysty
forte=mocny
debole=słaby
dolce=słodki
avere=mieć
andare=iść
albero=drzewo
borsa=torba
formaggio=ser
letto=łóżko
penna=długopis
quaderno=zeszyt
rosa=róża
semaforo=światła
tazza=filiżanka
accendino=zapalniczka
cerotto=plaster
passeggero=pasażer
antibiotico=antybiotyk
controllore=kontroler
poliziotto=policjant
aspirina=aspiryna
siringa=strzykawka
binario=peron;tor
treno=pociąg
prendere=brać
disinfettante=środek dezynfekcyjny
sciroppo=syrop
biglietteria=kasa biletowa
edicola=kiosk
sigaretta=papieros
bilancia=waga
francobollo=znaczek pocztowy
cartolina=pocztówka
medicina=medycyna
vaccino=szczepionka
busta=koperta
stazione=dworzec
farmacia=apteka
